11111111111111111111111111
10000000000000000000000011
11111111111111111111111111