1111111
1E111C1
1010001
100P101
1111101
1C00001
1111111